1111111111
1000C00001
1011101101
1010000101
1010110101
1C10010101
100001C101
11110100P1
1000E00111
1111111111